NO ./libft/ft_split.c
SO ./libft/ft_split.c
WE ./libft/ft_split.c
EA ./libft/ft_split.c

F 220,100,0
C 225,30,0

1111111111111111111111111
1100000000110000000000001
1111000001110000000000001
1001000000000000000000001
1111111110110000011100001
1000000000111000011111111
1111011111111101111
1111011111111101111111101
1100000011010101110000001
1000000000000000110000001
1000000000000000110101001
1100000111010101111101111
1111011111110101110111101
1111111111111111111111111
