NO ./textures/TECH_3D.xpm
SO ./textures/TECH_3G.xpm
WE ./textures/TECH_3I.xpm
EA ./textures/TECH_4F.xpm

F 220,100,0
C 225,30,0

        1111111111111111111111111
        1000000000110000000000001
        1011000001110000000000001
        1001000000000000S00000001
111111111011000001110000000000001
100000000011000001110111111111111
11110111111111011100000010001
11110111111111011101010010001
11000000110101011100000010001
10W000N0000000001100000010001
10000000000000001101010010001
1100E001110101011111011110N1111
11110111 1110101 101111010001
11111111 1111111 111111111111
